#                                #
#                                #
#            XXX                 #
#            XXX                 #
#                                #
#############H####################