X##X##X##X##X#####
#                #
# #  # #  # ###  #
# #  # #  # # #  #
# #### #  # #### #
# #  # #  # #  # #
# #  # #### #### #
#                #
### ##############
X## ##X##X##X#####
#                #
# #  # #  # ###  #
# #  # #  # # #  #
# #### #  # #### #
# #  # #  # #  # #
# #  # #### #### #
#                #
### ##############
X## ##X##X##X#####
#                #
# #  # #  # ###  #
# #  # #  # # #  #
# #### #  # #### #
# #  # #  # #  # #
# #  # #### #### #
#                #
### ##############
X## ##X##X##X#####
#                #
# #  # #  # ###  #
# #  # #  # # #  #
# #### #  # #### #
# #  # #  # #  # #
# #  # #### #### #
#                #
### ##############
X## ##X##X##X#####
#                #
# #  # #  # ###  #
# #  # #  # # #  #
# #### #  # #### #
# #  # #  # #  # #
# #  # #### #### #
#                #
### ##############
X## ##X##X##X#####
#                #
# #  # #  # ###  #
# #  # #  # # #  #
# #### #  # #### #
# #  # #  # #  # #
# #  # #### #### #
#                #
### ##############
X## ##X##X##X#####
#                #
# #  # #  # ###  #
# #  # #  # # #  #
# #### #  # #### #
# #  # #  # #  # #
# #  # #### #### #
#                #
### ##############
X## ##X##X##X#####
#                #
# #  # #  # ###  #
# #  # #  # # #  #
# #### #  # #### #
# #  # #  # #  # #
# #  # #### #### #
#                #
### ##############
X## ##X##X##X#####
#                #
# #  # #  # ###  #
# #  # #  # # #  #
# #### #  # #### #
# #  # #  # #  # #
# #  # #### #### #
#                #
### ##############
X## ##X##X##X#####
#                #
# #  # #  # ###  #
# #  # #  # # #  #
# #### #  # #### #
# #  # #  # #  # #
# #  # #### #### #
#                #
### ##############
X## ##X##X##X#####
#                #
# #  # #  # ###  #
# #  # #  # # #  #
# #### #  # #### #
# #  # #  # #  # #
# #  # #### #### #
#                #
### ##############
X## ##X##X##X#####
#                #
# #  # #  # ###  #
# #  # #  # # #  #
# #### #  # #### #
# #  # #  # #  # #
# #  # #### #### #
#                #
###H##############